 (Arizona	Phoenix	West	Grand Canyon South Rim),
 (Arkansas	Little Rock	South	Diamonds State Park),
 (California	Sacramento	West	Alcatraz Island),
 (Colorado	Denver	West	Pikes Peak Cog Railway),
 (Connecticut	Hartford	Northeast	Mystic Seaport),
 (Delaware	Dover	South	Funland),
 (Florida	Tallahassee	South	Dry Tortugas National Park),
 (Georgia	Atlanta	South	National Park Service),
 (Hawaii	Honolulu	West	Pearl Harbor),
 (Idaho	Boise	West	Coeur d'Alene Lake),
 (Illinois	Springfield	Midwest	Cloud Gate aka The Bean),
 (Indiana	Indianapolis	Midwest	Children's Museum of Indianapolis),
 (Iowa	Des Moines	Midwest	Iowa State Fair),
 (Kansas	Topeka	Midwest	OZ Museum),
 (Kentucky	Frankfort	South	Louisville Slugger Museum & Factory),
 (Louisiana	Baton Rouge	South	the Steamboat Natchez),
 (Maine	Augusta	Northeast	Acadia National Park),
 (Maryland	Annapolis	South	Assateague Island National Seashore),
 (Massachusetts	Boston	Northeast	Boston's 2.5-mile Freedom Trail),
 (Michigan	Lansing	Midwest	Sleeping Bear Dunes National Lakeshore),
 (Minnesota	St. Paul	Midwest	Nickelodeon Universe),
 (Mississippi	Jackson	South	Elvis Presley Birthplace and Museum),
 (Missouri	Jefferson City	Midwest	The Gateway Arch),
 (Montana	Helena	West	National Bison Range),
 (Nebraska	Lincoln	Midwest	Henry Doorly Zoo),
 (Nevada	Carson City	West	Neon Museum),
 (New Hampshire	Concord	Northeast	Mount Washington Auto Road),
 (New Jersey	Trenton	Northeast	Morey's Piers),
 (New Mexico	Santa Fe	West	White Sands National Monument),
 (New York	Albany	Northeast	Broadway show),
 (North Carolina	Raleigh	South	Blue Ridge Parkway),
 (North Dakota	Bismarck	Midwest	Theodore Roosevelt National Park),
 (Ohio	Columbus	Midwest	Rock and Roll Hall of Fame),

 (Oklahoma	Oklahoma City	South	The Cave House),
 (Oregon	Salem	West	Columbia River Gorge National Scenic Area ),
 (Pennsylvania	Harrisburg	Northeast	Hersheypark),
 (Rhode Island	Providence	Northeast	Newport's Ocean Drive),
 (South Carolina	Columbia	South	Hilton Head Island Bike Trails),
 (South Dakota	Pierre	Midwest	Crazy Horse Memorial and Mount Rushmore),
 (Tennessee	Nashville	South	Dollywood),
 (Texas	Austin	South	The DoSeum),
 (Utah	Salt Lake City	West	 National Dinosaur Monument),
 (Vermont	Montpelier	Northeast	Ben & Jerry's Factory Tour and Ice Cream Shop),
 (Virginia[E]	Richmond	South	Colonial Williamsburg),
 (Washington	Olympia	West	Cape Flattery),
 (West Virginia	Charleston	South	Harpers Ferry National Historic Park),
 (Wisconsin	Madison	Midwest	U.S. Mailboat Tour on Geneva Lake),
 (Wyoming	Cheyenne	West	National Elk Refuge)




('Arizona','Phoenix','West','Grand Canyon South Rim'),
 ('Arkansas','Little Rock','South','Diamonds State Park'),
 ('California','Sacramento','West','Alcatraz Island'),
 ('Colorado','Denver','West','Pikes Peak Cog Railway'),
 ('Connecticut','Hartford','Northeast','Mystic Seaport'),
 ('Delaware','Dover','South','Funland');